{
	"level_map": [[0,0,0,0,0,0,0,0,0,0],
				  [0,0,0,0,2,0,0,0,0,0],
				  [0,0,1,0,0,0,0,1,0,0],
				  [0,0,0,1,0,0,1,0,0,0],
				  [0,0,0,0,1,1,0,0,0,0],
				  [1,0,0,0,1,1,0,0,0,0],
				  [0,0,0,1,0,0,1,0,0,0],
				  [0,0,1,0,0,0,0,1,0,0],
				  [0,2,0,0,0,0,0,0,0,0],
				  [0,0,0,0,0,0,0,0,0,0]
				 ],
	"player_start": [0,0],
	"box_starts": [[3,1], [1,3]]
}
